ItemName	Type
Item_LingStone	原料
Item_LingCrystal	原料
Item_SoulCrystalYou	原料
Item_SoulCrystalNing	原料
Item_SoulCrystalLing	原料
Item_BrownRock	原料
Item_GrayRock	原料
Item_Marble	原料
Item_Jade	原料
Item_JadeEssence	原料
Item_StoneEssence	原料
Item_SkyStone	原料
Item_ExtremeJade	原料
Item_IronRock	原料
Item_CopperRock	原料
Item_SilverRock	原料
Item_DarksteelRock	原料
Item_StarEssence	原料
Item_Wood	原料
Item_HardWood	原料
Item_ParasolWood	原料
Item_LingWood	原料
Item_BoarLeather	原料
Item_RabbitLeather	原料
Item_BearLeather	原料
Item_WolfLeather	原料
Item_FeiLeather	原料
Item_LuShuLeather	原料
Item_YaoLeather	原料
Item_YaoLeather1	原料
Item_SilverGrit	原料
Item_CopperGrit	原料
Item_Cinnabar	原料
Item_LingMuXueJie	原料
Item_EarthEssence	原料
Item_EarthEssence1	原料
Item_EarthEssence_1	原料
Item_EarthEssence1_1	原料
Item_LifeStream	原料
Item_Ginseng	原料
Item_GanodermaLucidum	原料
Item_RedGinseng	原料
Item_PurpleGanodermaLucidum	原料
Item_SoulPearl	原料
Item_MonsterBlood	原料
Item_Mint	原料
Item_MagicHerb	原料
Item_Ginkgo	原料
Item_SnakeGallbladder	原料
Item_BearGallbladder	原料
Item_Healroot	原料
Item_Grass	原料
Item_Cotton	原料
Item_Shit	原料
Item_DragonShit	原料
Item_HorribleMeal	药食
Item_HomeFood	药食
Item_DeliciousFood	药食
Item_DelicacyFood	药食
Item_GuanyinMud	药食
Item_Water	药食
Item_DirtyWater	药食
Item_Hemostatics	药食
Item_SmallCycle	药食
Item_Plaster	药食
Item_StoneEssenceDrug	药食
Item_Anodyne	药食
Item_Laxative	药食
Item_Fruit	药食
Item_LingWater	药食
Item_ZaoHuaYuLu	药食
Item_Cake	药食
Item_Jerky	药食
Item_PreservedFruit	药食
Item_Yao_BoarMeat	药食
Item_Flour	药食
Item_Pear	药食
Item_Wheat	药食
Item_Mushroom	药食
Item_Lotusroot	药食
Item_BoarMeat	药食
Item_FrogMeat	药食
Item_TurtleMeat	药食
Item_BearMeat	药食
Item_Beef	药食
Item_RabbitMeat	药食
Item_ChickenMeat	药食
Item_WolfMeat	药食
Item_FishMeat	药食
Item_SnakeMeat	药食
Item_ChickenEgg	药食
Item_SnakeEgg	药食
Item_TurtleEgg	药食
Item_LongEgg	药食
Item_FengEgg	药食
Item_Jiaozi	药食
Item_Dan_Fail1	灵丹
Item_Dan_Fail2	灵丹
Item_Dan_Fail3	灵丹
Item_Dan_Fail4	灵丹
Item_Dan_Fail5	灵丹
Item_BasePracticeDrug	灵丹
Item_Dan_JingYuan	灵丹
Item_Dan_JingYuan2	灵丹
Item_Dan_JingYuan3	灵丹
Item_Dan_Ling	灵丹
Item_Dan_Ling2	灵丹
Item_Dan_PracticeRate	灵丹
Item_Dan_PracticeSpeed	灵丹
Item_Dan_CalmDown	灵丹
Item_Dan_Happiness	灵丹
Item_Dan_NoHunger	灵丹
Item_Dan_NoHunger2	灵丹
Item_Dan_NoHunger1	灵丹
Item_Dan_LostSoul	灵丹
Item_Dan_DredgeQi1	灵丹
Item_Dan_DredgeQi	灵丹
Item_Dan_WuLingSan	灵丹
Item_Dan_CureJinDamage	灵丹
Item_Dan_CureMuDamage	灵丹
Item_Dan_CureShuiDamage	灵丹
Item_Dan_CureHuoDamage	灵丹
Item_Dan_CureTuDamage	灵丹
Item_Dan_CureFiveElementDamage	灵丹
Item_Dan_Restore	灵丹
Item_Dan_ExtremeLofty	灵丹
Item_Dan_HundredRefine	灵丹
Item_Dan_IncreaseLife1	灵丹
Item_Dan_IncreaseLife2	灵丹
Item_Dan_IncreaseLife3	灵丹
Item_Dan_IncreaseLife4	灵丹
Item_Dan_IncreaseLife5	灵丹
Item_Dan_IncreaseNeckCountdown1	灵丹
Item_Dan_IncreaseNeckCountdown2	灵丹
Item_Dan_SwordBall	灵丹
Item_Dan_Defense	灵丹
Item_Dan_Ling3	灵丹
Item_Dan_FiveBase1	灵丹
Item_Dan_FiveBase2	灵丹
Item_Dan_FiveBase3	灵丹
Item_Dan_FiveBase4	灵丹
Item_Dan_FiveBase5	灵丹
Item_Dan_FiveBaseFromLife	灵丹
Item_Dan_TreeEXP	灵丹
Item_Dan_Thin	灵丹
Item_Dan_Fat	灵丹
Item_Dan_FaceLock	灵丹
Item_Dan_FaceUnLock	灵丹
Item_Dan_Soul1	灵丹
Item_Dan_Soul2	灵丹
Item_Dan_Soul3	灵丹
Item_Dan_Soul4	灵丹
Item_Dan_LunHui1	灵丹
Item_Dan_ReBorn	灵丹
Item_Dan_ReBorn_4	灵丹
Item_Dan_LingYuanZhong	灵丹
Item_Dan_LingYuanSha	灵丹
Item_Dan_LongDan1	灵丹
Item_Dan_FengDan1	灵丹
Item_Dan_ZhuLongDan1	灵丹
Item_Dan_FenShen1	灵丹
Item_Dan_FenShen2	灵丹
Item_Dan_FenShen3	灵丹
Item_Dan_TiShen	灵丹
Item_Dan_FX1_01	灵丹
Item_Dan_FX1_02	灵丹
Item_Dan_FX1_03	灵丹
Item_Dan_FX1_04	灵丹
Item_Dan_FX1_05	灵丹
Item_Dan_FX1_06	灵丹
Item_Dan_FX1_07	灵丹
Item_Dan_FX1_08	灵丹
Item_Dan_FX2_01	灵丹
Item_Dan_FX2_02	灵丹
Item_Dan_FX2_03	灵丹
Item_Dan_FX2_04	灵丹
Item_Dan_FX2_05	灵丹
Item_Dan_FX2_06	灵丹
Item_Dan_FX2_07	灵丹
Item_Dan_FX2_08	灵丹
Item_Dan_SN1_01	灵丹
Item_Dan_SN1_02	灵丹
Item_Dan_SN1_03	灵丹
Item_Dan_SN2_01	灵丹
Item_Dan_SN2_02	灵丹
Item_Dan_SN2_03	灵丹
Item_Dan_SN3_01	灵丹
Item_Dan_SN3_02	灵丹
Item_Dan_SN3_03	灵丹
Item_Dan_SN3_04	灵丹
Item_Dan_SN4_01	灵丹
Item_Dan_SN4_02	灵丹
Item_Dan_SN4_03	灵丹
Item_Dan_SN4_04	灵丹
Item_Dan_NW1_01	灵丹
Item_Dan_NW1_02	灵丹
Item_Dan_NW1_03	灵丹
Item_Dan_NW1_04	灵丹
Item_Dan_NW1_05	灵丹
Item_Dan_NW2_01	灵丹
Item_Dan_NW2_02	灵丹
Item_Dan_NW2_03	灵丹
Item_Dan_NW2_04	灵丹
Item_Dan_NW2_05	灵丹
Item_Dan_NW3_01	灵丹
Item_Dan_NW3_02	灵丹
Item_Dan_NW3_03	灵丹
Item_Dan_NW3_04	灵丹
Item_Dan_NW3_05	灵丹
Item_Dan_NW3_06	灵丹
Item_Dan_SN_A01	灵丹
Item_Dan_SN_A02	灵丹
Item_Dan_SN_A03	灵丹
Item_Dan_SN_A04	灵丹
Item_Dan_SN_B01	灵丹
Item_Dan_SN_B02	灵丹
Item_Dan_SN_B03	灵丹
Item_Dan_SN_B04	灵丹
Item_Dan_SN_C01	灵丹
Item_Dan_SN_C02	灵丹
Item_Dan_SN_C03	灵丹
Item_Dan_SN_C04	灵丹
Item_Dan_SN_D01	灵丹
Item_Dan_SN_D02	灵丹
Item_Dan_SN_D03	灵丹
Item_Dan_SN_D04	灵丹
Item_yangjin1	灵丹
Item_yangjin2	灵丹
Item_yangjin3	灵丹
Item_yangjin4	灵丹
Item_yangjin5	灵丹
Item_yangjin6	灵丹
Item_yinjin1	灵丹
Item_yinjin2	灵丹
Item_yinjin3	灵丹
Item_yinjin4	灵丹
Item_yinjin5	灵丹
Item_yinjin6	灵丹
Item_ThunderAir	天材地宝
Item_XianBone	天材地宝
Item_XianBoneBall	天材地宝
Item_ZaoHuaYuZi	天材地宝
Item_BenYuan_None	天材地宝
Item_YuanHunLu	天材地宝
Item_XieHunLu	天材地宝
Item_YanDaoGuo	天材地宝
Item_QieDaoGuo	天材地宝
Item_XianDaoShenNian	天材地宝
Item_XianDaoXieNian	天材地宝
Item_WinterWarm	天材地宝
Item_SummerHerb	天材地宝
Item_God_ZhiNianJieJing	天材地宝
Item_BenYuan_Jin	天材地宝
Item_BenYuan_Mu	天材地宝
Item_BenYuan_Shui	天材地宝
Item_BenYuan_Huo	天材地宝
Item_BenYuan_Tu	天材地宝
Item_JinEssence	天材地宝
Item_MuEssence	天材地宝
Item_ShuiEssence	天材地宝
Item_HuoEssence	天材地宝
Item_TuEssence	天材地宝
Item_JinEX	天材地宝
Item_MuEX	天材地宝
Item_ShuiEX	天材地宝
Item_HuoEX	天材地宝
Item_TuEX	天材地宝
Item_WuEX	天材地宝
Item_IronBlock	材料
Item_CopperBlock	材料
Item_SilverBlock	材料
Item_CopperBlock1	材料
Item_SilverBlock1	材料
Item_DarksteelBlock	材料
Item_StarEssenceBlock	材料
Item_BrownRockBlock	材料
Item_GrayRockBlock	材料
Item_MarbleBlock	材料
Item_JadeBlock	材料
Item_SkyStoneBlock	材料
Item_LingStoneBlock	材料
Item_LingCrystalBlock	材料
Item_RoughWoodBlock	材料
Item_HardWoodBlock	材料
Item_ParasolWoodBlock	材料
Item_LingWoodBlock	材料
Item_CottonCloth	材料
Item_DeepBlueCloth	材料
Item_PurpleCloth	材料
Item_YellowCloth	材料
Item_BlueCloth	材料
Item_RedCloth	材料
Item_WhiteCloth	材料
Item_BlackCloth	材料
Item_WoodLeftover	材料
Item_HardWoodLeftover	材料
Item_ParasolWoodLeftover	材料
Item_LingWoodLeftover	材料
Item_BrownRockLeftover	材料
Item_GrayRockLeftover	材料
Item_MarbleLeftover	材料
Item_JadeLeftover	材料
Item_SkyStoneLeftover	材料
Item_LingStoneLeftover	材料
Item_LingCrystalLeftover	材料
Item_IronRockLeftover	材料
Item_CopperRockLeftover	材料
Item_SilverRockLeftover	材料
Item_DarksteelRockLeftover	材料
Item_StarEssenceLeftover	材料
Item_JL_01	材料
Item_JL_02	材料
Item_JL_03	材料
Item_JL_04	材料
Item_JL_05	材料
Item_JL_06	材料
Item_JC_01	材料
Item_JC_02	材料
Item_JC_03	材料
Item_JC_04	材料
Item_JC_05	材料
Item_JC_06	材料
Item_Firecracker	材料
Item_FirecrackerShit	材料
Item_Yingbi1	材料
Item_Yingbi2	材料
Item_Yingbi3	材料
Item_SpellPaper	材料
Item_SpellPaperLv2	材料
Item_SpellPaperLv3	材料
Item_BossFeng_HuoYu	神兽材料
Item_BossFeng_GangYu	神兽材料
Item_BossFeng_TouYu	神兽材料
Item_BossFeng_WeiYu	神兽材料
Item_BossFeng_Gu	神兽材料
Item_BossFeng_HongYu	神兽材料
Item_BossFeng_Meat	神兽材料
Item_DragonScale	神兽材料
Item_BossLong_Jiao	神兽材料
Item_BossLong_Zhua	神兽材料
Item_BossLong_Lin	神兽材料
Item_BossLong_NiLin	神兽材料
Item_BossLong_Jing	神兽材料
Item_BossLong_Meat	神兽材料
Item_BossZhuLong_BaiLin	神兽材料
Item_BossZhuLong_HeiLin	神兽材料
Item_BossZhuLong_Eye	神兽材料
Item_BossZhuLong_TianLin	神兽材料
Item_BossZhuLong_LongYu	神兽材料
Item_BossZhuLong_Meat	神兽材料
Item_BossFeng_FengYin	神兽材料
Item_BossZhuLong_FengYin	神兽材料
